name Small Labyrinth of Dooom
win 3
##########################
#........................#
#.....###........###.....#
#......G..........G......#
#........................#
#...........E............#
#......G.........G.......#
#........G.....G.........#
#..........###...........#
#........................#
##########################